                                                                                
                                                      ╔════════╗                
         ╔═════╗                                      ║  DHH   ║                
         ║Meem ║                                      ║   x    ║                
         ║  x  ║                                      ╚═══╤════╝                
         ╚══╤══╝                             ╔════════════╧══════════╗          
            │     ╔══════╗                   ║                       ║          
            │     ║Plaza ╟───────────────────╢     Walker Lawn       ║   ╔════╗ 
            ├─────╢      ║                   ║                       ╟───╢Roza║ 
            │     ║   x  ║   ╔═════════════╗ ║           x           ║   ║ x  ║ 
         ╔══╧══╗  ║      ╟───╢ x   Reki    ║ ║                       ║   ╚════╝ 
         ║Admin║  ╚══════╝   ║   ╔═════╗   ║ ║                       ║          
         ║  x  ║     ▌▐      ║   ║     ║   ║ ╚═══╤═══════════════════╝          
         ╚═════╝     ▌▐      ╚═══╝     ╚═══╝     │                              
                     ▌▐                          │                              
▀▀▀▀▀▀▀▀▀▀▀▀▀▀▀▀▀▀▀▀▀▀▀▀▀▀▀▀▀▀▀▀▀▀▀▀▀▀▀▀▀▀▀▀▀▀▀▀▀│▀▀▀▀▀▀▀▀▀▀▀▀▀▀▀▀▀▀▀▀▀▀▀▀▀▀▀▀▀▀
▄▄▄▄▄▄▄▄▄▄▄▄▄▄▄▄▄▄▄▄▄▄▄▄▄▄▄▄▄▄▄▄▄▄▄▄▄▄▄▄▄▄▄▄▄▄▄▄▄│▄▄▄▄▄▄▄▄▄▄▄▄▄▄▄▄▄▄▄▄▄▄▄▄▄▄▄▄▄▄
                                                 │                              
                                               ╔═╧══╗           ╔═══╗           
                                               ║    ║           ║   ║           
                                               ║    ╚═══════════╝   ║           
                                               ║     Wads  x        ║           
                                               ╚══════════╤═════════╝           
                                                          │                     
                                                          │                     
                                                     ╔════╧════╗                
                                                     ║ Trails  ║                
                                                     ║    x    ║                
                                                     ╚═════════╝                
                                                                                
00000000011111111112222222222333333333344444444445555555555666666666677777777778
12345678901234567890123456789012345678901234567890123456789012345678901234567890
